#####.#####
#.........#
#.#########
#.........#
#.#######.#
#...#.#...#
###.#.#.#.#
#.#...#.#.#
#.#.###.#.#
#...#...#.#
#####.#####
