###...#####.....##
........#........#
........#........#
........#........#
....#...#...#....#
....#...#...#....#
##################
